
  * * * * *               * * * * *               * * * * *  
  *       *               *       *               *       *  
  *       * * * * * * * * *       * * * * * * * * *       *  
  *       *               *       *               *       *  
  * * * * *               * * * * *               * * * * *  
      *     *                 *                 *     *      
      *       *               *               *       *      
      *         *             *             *         *      
      *           *           *           *           *      
      *             *         *         *             *      
      *               *       *       *               *      
      *                 *     *     *                 *      
  * * * * *               * * * * *               * * * * *  
  *       *               *       *               *       *  
  *       * * * * * * * * *       * * * * * * * * *       *  
  *       *               *       *               *       *  
  * * * * *               * * * * *               * * * * *  
      *                 *     *     *                 *      
      *               *       *       *               *      
      *             *         *         *             *      
      *           *           *           *           *      
      *         *             *             *         *      
      *       *               *               *       *      
      *     *                 *                 *     *      
  * * * * *               * * * * *               * * * * *  
  *       *               *       *               *       *  
  *       * * * * * * * * *       * * * * * * * * *       *  
  *       *               *       *               *       *  
  * * * * *               * * * * *               * * * * *  

