


      * * * * * * * * * * * * * * * * * * * * * * * * * 
      * *                     *                     * * 
      *   *                   *                   *   * 
      *     *                 *                 *     * 
      *       *               *               *       * 
      *         *             *             *         * 
      *           *           *           *           * 
      *             *         *         *             * 
      *               *       *       *               * 
      *                 *     *     *                 * 
      *                   *   *   *                   * 
      *                     * * *                     * 
      * * * * * * * * * * * * * * * * * * * * * * * * * 
      *                     * * *                     * 
      *                   *   *   *                   * 
      *                 *     *     *                 * 
      *               *       *       *               * 
      *             *         *         *             * 
      *           *           *           *           * 
      *         *             *             *         * 
      *       *               *               *       * 
      *     *                 *                 *     * 
      *   *                   *                   *   * 
      * *                     *                     * * 
      * * * * * * * * * * * * * * * * * * * * * * * * * 


